$$$$$$$$$$$ $$$$$$$$$
$$$$$$$$       $$$$$$
$$$$$$$$$$ $$$ $$$$$$
$$$$$      $$$ $$$$$$
$$$$$ $$$$$$      $$$
$$$$    $$    $$$$$$$
$$$$$$$$$$$$ $$$$$$$$
$$$$$$$$$$$$  $$$$$$$
$$$$$$$$$$$$$       $
$$$$$$$$$$$$$$$$$ $$$